XXXXXXXXXX
X---P----X
X-XXXXXX-X
X--------X
X-XXXXXX-X
X--------X
X-XX-XXX-X
X-XX-XXX-X
X--D-----X
XXXXXXXXXX
