XXXXXXXXXX
XX------DX
XX-XX--X-X
XX-XX----X
XX-XX..XXX
XX-XX--XXX
XX-XX--XXX
XX-XXX-XXX
XP-------X
XXXXXXXXXX
